1111111111111
10000000000C1
1001111111111
1P000000100E1
1111111111111
